111111111111
100100000C01
100101111101
1P0011E00001
111111111111
