111111111111
11C100C00001
111001111101
1P0011E00001
111111111111
