111111111111
100100000001
100001111101
1P0011E10001
111111111111
